1111111111111111111111111111111111111
1E10001011101110101100000000000000001
111000111111111111100010C000011111111
10C0000000C000000011000100000000C0001
1011101011111010111000001000000000001
1111111011101010001000000100000100111
1000111011111010111000000010000100001
101010101111111010100001111110010C001
11101110100C0010111A00000010000C00001
1000C00C10101C0000000C0000100000000P1
1111111111111111111111111111111111111