111111111111111
100000000000001
10011111110E001
10000000C100001
10P111011100001
100000000000001
111111111111111
