111111111111111
100000000000001
10011111110E001
10000001C110001
10P111011100001
10000CCC0000001
111111111111111