111111111111111
1C0A0000E000101
10010000C110111
1P01111C1100001
111111111111111