111111111111
1CA0000001E1
110000000C01
1P00000C0001
111111111111