11111111111111111111111
10000P00000000000000001
100111111110000000E0001
100000000C1000001111001
10011110111000111111001
10000010000000000000001
11111111111111111111111