11111111111111111111111
10000P00000000000000001
10011111111000000001001
10000000001000001111001
10011110111000000001001
10000010000000000000001
11111111111111111111111