111111111111111
1A0000000000001
1P011111111E101
10000000C111111
100111011100001
10000CCC0000001
111111111111111