111111111111111
100P00000000001
10011111110E001
10000000C100001
100111011100001
100000000000001
111111111111111

