111111111111111
10A000000C00001
100111111E10101
10P00000C111111
1001111C1100001
10000CCC0000001
111111111111111