111111111111111
1A000000EC00001
100111111010101
1000P000C111111
100111011100001
10000CCC0000001
111111111111111