111111111111111
11C1000000001E1
11000000C000001
1P00001C1000001
111111111111111