111111111111111
100000000000001
10011111111E101
10000000C111111
10P111011100001
10000CCC0000001
111111111111111