111111111111111
11C1A00000000E1
11100000C000001
1P00000C0000001
111111111111111