11111111111111111111111
10000000000000000000001
10010011000000110011001
10110000100100001000101
10010011101E10111000101
100100001A0000001000101
10111011000000110000101
10000000000000000000001
10000000000000000000001
100C00CC000000CC00CC001
10CC0000C00C0000C000C01
100C00CCC00P00CCC000C01
100C0000C0CCC000C000C01
10CCC0CC000000CC0000C01
10000000000000000000001
11111111111111111111111