1111111
1P001C1
1E10001
1111111